
Stage 1
#####
#OoP#
#####
=====
Stage 2
  #######
###  O  ###
#    o    #
# Oo P oO #
###  o  ###
 #   O  #
 ########
=====
Stage 3
  #########
  ##   O  #
##O   oo ##
 ### P   ##
   ######
Stage 4
########
#O o  O#
#     #####
#0 o      #
#       P #
###########
=====
Stage 5
########
#      #
# ##oo ##
#   0  O#
#P# o####
#O  O#
######